EEEEEEEEEEEEEEEEEEEEEEEEEEEEEE
EPCCWFFFFFFFFFFFFFFFFFFFFFFFFE
EFFFSFFFFFFFFFFFFFFFFFFFFFFFFE
EFFFFFFFFFFFFFFFFFFFFFFFFFFFFE
EMMMWFFFFFFFFFFFFFFFFFFFFFFFFE
EFFFFFFFFFFFFFFFFFFFFFFFFFFFFE
EFFFFFFFFFFFFFFFFFFFFFFFFFFFFE
EFFFFFFFFFFFFFFFFFFFFFFFFFFFFE
EFFFFFFFFFFFFFFFFFFFFFFFFFFFFE
EFFFFFFFFFFFFFFFFFFFFFFFFFFFFE
EFFFFFFFFFFFFFFFFFFFFFFFFFFFFE
EFFFFFFFFFFFFFFFFFFFFFFFFFFFFE
EFFFFFFFFFFFFFFFFFFFFFFFFFFFFE
EFFFFFFFFFFFFFFFFFFFFFFFFFFFFE
EFFFFFFFFFFFFFFFFFFFFFFFFFFFFE
EFFFFFFFFFFFFFFFFFFFFFFFFFFFFE
EFFFFFFFFFFFFFFFFFFFFFFFFFFFFE
EFFFFFFFFFFFFFFFFFFFFFFFFFFFFE
EFFFFFFFFFFFFFFFFFFFFFFFFFFFFE
EFFFFFFFFFFFFFFFFFFFFFFFFFFFFE
EFFFFFFFFFFFFFFFFFFFFFFFFFFFFE
EFFFFFFFFFFFFFFFFFFFFFFFFFFFFE
EFFFFFFFFFFFFFFFFFFFFFFFFFFFFE
EFFFFFFFFFFFFFFFFFFFFFFFFFFFFE
EFFFFFFFFFFFFFFFFFFFFFFFFFFFFE
EFFFFFFFFFFFFFFFFFFFFFFFFFFFFE
EFFFFFFFFFFFFFFFFFFFFFFFFFFFFE
EFFFFFFFFFFFFFFFFFFFFFFFFFFFFE
EFFFFFFFFFFFFFFFFFFFFFFFFFFFFE
EEEEEEEEEEEEEEEEEEEEEEEEEEEEEE